######################################################
# P                   O           #######           O#
# ###### # # # ##### # ######## #        O# #O###### #
# #    # # # #     # # #      # ########### # #    # #
# #    # # # ###O# # # #      #           # # #    # #
# ###### # #     #   # #      ##########  # # ###### #
# O      # # ####### # #      #           # #       O#
# ######## #         # ######## ########### ######## #
# #  O#### ###########O         #                  # #
# # #                ############################# # #
# # ################ #  #                        #O# #
# #          O       #  # ##O###################     #
# ####################### ## ####################### #
#     ###################O## #  #                  #O#
#O# #        O               #  # ################ # #
# # #############################                # # #
# #                  #          ########### ####   # #
# ######## ########### ######## #         # ######## #
#        # #   O       #      # # ####### # #  O     #
# ######O# # ###########      # #   #   O #O# ###### #
# #    # # #           #      # # # # ### # # #    # #
# #    # # ##########  #      # # #O    # # # #    # #
# ###### # #       O#  ######## # ####  # # # ###### #
#            ######                                 O#
######################################################
